Ala	A
Arg	R
Asn	N
Asp	D
Asx	B
Cys	C
Glu	E
Gln	Q
Glx	Z
Gly	G
His	H
Ile	I
Leu	L
Lys	K
Met	M
Phe	F
Pro	P
Ser	S
Thr	T
Trp	W
Tyr	Y
Val	V
